60
10
0,0,0,0,0,0,0,0,0,0,0,0,0,0,0,0,0,0,0,0,0,0,0,0,0,0,0,0,0,0,0,0,0,0,0,0,0,0,0,0,0,0,0,0,0,0,0,0,0,0,0,0,0,0,0,0,0,0,0,0,
0,0,0,0,0,0,0,0,0,0,0,0,0,0,0,0,0,0,0,0,0,0,0,0,504,505,0,0,0,0,0,0,0,0,0,0,0,534,534,534,0,0,0,0,0,0,0,0,0,0,0,0,0,0,0,0,0,0,0,0,
0,0,0,0,0,0,0,0,0,0,0,0,0,0,0,0,0,0,0,0,0,0,0,534,536,537,534,0,0,0,0,0,0,0,0,0,0,215,187,188,0,0,534,534,0,534,568,0,0,0,0,0,0,0,0,0,0,0,0,0,
0,0,0,0,0,0,0,0,310,311,0,313,314,315,316,317,0,0,0,0,0,0,0,55,56,59,60,0,0,0,0,0,0,0,0,0,0,216,219,0,0,0,153,154,408,153,154,0,0,0,0,0,0,0,0,0,0,0,0,0,
0,0,0,0,0,0,534,0,152,343,344,345,346,347,348,280,0,0,0,0,0,534,0,0,153,154,0,0,0,0,0,0,0,0,0,0,0,184,219,0,0,0,0,0,408,0,0,0,0,0,0,0,0,0,0,0,0,0,0,0,
0,0,0,0,534,0,152,0,0,375,376,377,378,379,380,381,0,0,0,0,0,152,0,0,0,0,0,0,0,0,0,0,0,0,0,0,0,216,219,0,0,0,0,0,408,0,0,0,0,504,505,0,0,0,0,0,0,0,0,0,
0,0,0,0,152,0,0,0,0,0,0,0,0,0,0,534,534,534,534,534,534,534,534,0,0,0,0,0,0,0,534,0,0,0,0,534,534,216,219,534,535,0,0,0,408,0,0,0,0,536,537,0,0,0,0,0,0,0,0,0,
534,534,534,534,534,534,534,534,534,534,534,0,0,0,0,183,184,185,185,185,185,187,188,0,0,0,0,0,0,0,87,0,0,0,0,55,56,57,58,59,60,0,0,0,152,0,0,280,0,183,188,0,55,56,59,60,0,0,0,0,
57,57,57,57,57,57,57,57,57,59,60,406,406,406,407,407,216,217,217,217,217,219,406,407,406,407,406,407,406,407,119,406,407,406,407,406,88,89,90,91,406,407,406,407,406,407,407,406,407,406,407,406,407,88,91,152,55,56,57,58,
89,89,89,89,89,89,89,89,89,91,438,439,438,439,438,439,216,217,217,217,217,219,438,439,438,439,438,439,438,439,439,438,439,438,439,438,88,89,90,91,438,439,438,439,438,439,439,438,439,438,439,438,439,120,123,152,87,88,89,90
bloqueante
(57,89,91,152,375,376,377,378,379,380,381,216,217,219,)
