60
10
3672,3673,3674,2356,2356,2356,2356,3867,3868,3869,3870,3870,3743,2356,2356,2356,2356,3223,3224,3225,3226,2356,2356,2356,2356,2356,2356,2356,2356,3357,3358,457,457,2356,2356,2356,2356,2356,2356,2356,2356,3292,3293,3294,3295,2356,2356,2356,2356,2356,2356,2356,2356,3967,2356,2356,2356,2356,2356,2356,
3929,3929,3929,3929,3929,3929,3930,3931,2356,2356,2356,2356,3807,2356,2356,3809,3810,3287,3288,3289,3290,2356,2356,2356,2356,4063,4064,2356,2356,3486,3873,457,457,2356,2356,2356,2356,2356,2356,2356,2356,2356,3486,2356,2356,2356,3431,3432,2356,2356,2356,2356,2356,4031,2356,2356,2356,5126,5127,2356,
3495,3496,2356,2356,2356,2356,2356,2356,2356,2356,2356,2356,3871,2356,2356,3431,3432,2356,2356,3481,2356,2356,2356,2356,2356,2356,2356,2356,2356,2356,2356,457,2356,2356,2356,2356,2356,2356,2356,2356,2356,2356,4834,2356,2356,2356,2356,2356,2356,2356,2356,2356,2356,2356,2356,2356,2356,5142,5143,2356,
3559,3560,2356,2356,2356,2356,2356,3809,3810,2356,2356,2356,4834,2356,2356,2356,2356,2356,3809,3810,2356,2356,4388,4389,2356,2356,2356,4388,4389,2356,2356,457,2356,2356,2356,2356,2356,2356,2356,2356,2356,2356,2356,2356,2356,2356,2356,2356,2356,2356,2356,2356,2356,2356,2356,2356,2356,5158,5159,2356,
3495,3496,2356,2356,2356,2356,2356,3873,3874,2356,2356,2356,4898,2356,2356,2356,2356,2356,3873,3874,2356,2356,2356,2356,2356,2356,2356,2356,2356,2356,2356,2356,2356,2356,2356,2356,2356,2356,2356,2356,2356,2356,2356,2356,2356,2356,2356,2356,2356,2356,2356,2356,2356,2356,4282,4283,2356,5174,5175,2356,
3559,3560,2356,2356,2356,2356,2356,2356,2356,2356,2356,2356,2356,2356,2356,2356,2356,2356,2356,2356,2356,2356,2356,2356,2356,2356,2356,2356,2356,2356,2356,2356,3214,2356,2356,2356,2356,2356,2356,3402,3431,3432,3432,2356,2356,2356,2356,3431,3432,2356,2356,2356,2356,2356,4346,4347,4348,4349,4350,4351,
3623,3624,3798,3799,2356,2356,2356,2356,2356,2356,2356,2356,3431,3432,2356,2356,2356,2356,2356,1607,1609,2356,2356,2356,2356,2356,2356,2356,2356,3809,3810,3810,2356,2356,2356,2356,2356,2356,3402,3402,2356,2356,2356,2356,2356,2356,2356,2356,2356,2356,2356,2356,2356,4409,4410,4411,2356,4215,4216,2356,
2356,2356,3862,3863,2356,2356,3894,3895,2356,2356,2356,2356,3873,3874,2356,2356,2356,2356,4937,4359,4359,4359,4881,4882,4883,4884,4885,4886,2356,3873,3874,3874,2356,2356,2356,2356,3271,3272,3273,3274,3275,3276,3277,2356,2356,2356,2356,2356,2356,2356,2356,2356,4409,4410,2356,4541,3809,3810,3811,3812,
4977,4977,4977,4977,4978,4979,4980,4981,3449,3450,2356,2356,2356,2356,2356,2356,2356,4937,5001,2356,2356,2356,4945,4946,4947,4948,4949,4950,2356,2356,2356,2356,2356,2356,2356,2356,2356,3534,2356,2356,2356,3534,2356,2356,2356,2356,2356,2356,2356,2356,2356,4472,4473,2356,2356,4541,3873,3874,3875,3876,
4228,4228,4228,4228,4228,4228,4228,4228,3513,3514,4996,4996,4996,4997,4998,4999,5000,5001,5065,2356,2356,2356,2356,4763,4947,4948,4949,4763,3815,3816,3428,3428,3428,3428,3428,3428,4885,3598,4883,4884,4885,3598,4885,4885,3964,3965,5000,3964,3965,5000,3964,3965,5000,5000,5000,4541,5000,5000,5000,5000
[Bloques bloqueadores]
