60
10
180,180,180,180,180,180,180,180,180,180,180,180,147,147,147,147,147,598,599,600,601,602,180,180,180,180,180,180,180,180,180,180,180,180,180,180,180,180,180,180,180,180,180,180,180,180,180,180,180,180,180,180,180,180,180,180,180,180,180,180,
180,180,180,180,180,180,180,147,147,147,147,147,147,180,180,180,147,630,631,632,633,634,180,180,180,180,180,180,180,180,180,180,180,180,180,180,180,180,180,180,180,180,180,180,180,180,180,180,180,180,180,180,180,180,180,180,180,180,180,180,
180,180,180,180,598,599,600,601,602,180,180,180,180,180,180,180,180,180,180,180,180,180,180,180,180,180,180,180,180,180,180,180,180,180,180,180,180,180,180,180,180,180,180,180,180,180,180,180,180,180,180,180,180,180,180,180,180,180,180,180,
180,147,147,147,630,631,632,633,634,180,180,180,180,180,74,180,180,180,180,180,180,180,180,180,180,180,180,180,180,180,180,180,180,180,180,180,180,180,180,180,180,180,180,180,180,180,180,180,180,180,180,180,180,180,180,180,180,180,180,180,
180,180,180,147,147,147,147,147,147,147,147,147,180,180,395,57,398,180,180,180,180,180,180,180,180,598,599,600,601,602,180,180,180,180,180,180,180,180,180,180,180,180,180,180,180,180,180,180,180,180,180,180,180,180,180,180,180,180,180,180,
180,180,180,180,180,180,180,180,180,180,180,180,180,180,88,89,91,180,180,180,180,180,180,180,180,630,631,632,633,634,180,180,180,180,180,180,180,180,180,180,180,180,180,180,180,180,180,180,180,180,180,180,180,180,180,180,180,180,180,180,
180,74,180,180,180,180,74,180,180,74,180,180,180,180,88,89,91,180,180,180,180,180,180,180,180,180,180,180,180,180,180,180,180,180,180,180,180,180,180,180,180,180,180,180,180,180,180,180,180,180,180,180,180,180,180,180,180,180,180,180,
57,57,57,57,57,57,57,57,57,105,242,180,180,180,88,89,91,180,180,180,180,180,180,74,180,180,180,180,567,568,180,180,180,180,566,180,180,180,180,180,180,180,180,566,180,180,180,180,180,180,180,180,180,180,180,180,566,180,180,180,
89,89,89,89,89,89,89,89,89,89,91,406,406,406,88,89,91,180,125,125,57,57,57,57,57,57,57,57,57,57,57,57,57,57,57,57,57,57,57,57,57,57,57,57,57,57,57,57,57,57,57,57,57,57,57,57,57,57,57,57,
89,89,89,89,89,89,89,89,89,89,91,438,439,439,88,89,91,406,406,406,89,89,89,89,89,89,89,89,89,89,89,89,89,89,89,89,89,89,89,89,89,89,89,89,89,89,89,89,89,89,89,89,89,89,89,89,89,89,89,89
[Bloques Bloqueanntes]
240,241,57,56,87,119,90,122